   ##########################################################
  #            ###                                           #
 #            #                                               #
#            #                                                 #
#                          #######                              #
##                       # #     ##                  #          #
###                      ##   K  ##                ###          #
####                     #     # #                 ###         #
###                                                  #        # 
##                                                   #       #
#                                                          ##
 ############################################################